#########
#   #   #
# ### # #
#   # # #
# # # # #
# #   # #
#########
